BBBBBBBBBBPPPBBBBBBB
WWW.C.........C..WWW
WW......WW.....W..WW
D..CW...WWC...WW...W
D...W...W......W...D
D...WW.C...WW......D
W..C........W......D
WW....WW...CW...C.WW
WWW...WWC.......WWWW
WWWWW.....C..WWWWWWW
WWWWWWWPPPWWWWWWWWWW