BBBBBBBBBBDDDBBBBBBB
WWWC...C.........WWW
WW......WW...C.W..WW
D..CWW..W.C....W...W
D..WW...W......WW..W
D......C...WW......W
W........C..W..C...W
WW.....WW...W.....WW
WWW...WW.....C..WWWW
WWWWW.....C..WWWWWWW
WWWWWWWDDDWWWWWWWWWW