BBBBBBBBBBBBBBBBBBBB
WWW.C..WWWWWW....WWW
WW......WWWW.C.W..WW
P..CWW..WWW....WW..W
P..WW....D.....WW..P
P......C.D.WWW.....P
WC..WWC..D...W.C...P
WW...W..WWWC......WW
WWW...C.WWW......WWW
WWWWW..WWWWWW..CWWWW
WWWWWWWWWWWWWWWWWWWW